9 9 9 9 9 9 9 9 9 9 9 9 9 9
9 9 9 9 9 9 2 2 2 2 2 2 2 9
9 9 9 9 9 9 2 2 2 2 2 2 2 9
9 9 9 9 9 9 2 2 2 2 2 2 2 9
9 9 9 9 9 9 2 2 2 2 2 2 2 9
9 9 9 9 9 2 2 2 2 2 2 2 2 9
9 9 9 9 9 2 2 2 2 2 2 2 2 9
9 9 9 9 9 2 2 2 2 2 2 2 2 9
9 9 9 9 9 2 2 2 2 2 2 2 2 9
9 2 2 2 2 2 2 2 2 2 2 2 2 9
9 2 2 2 2 2 2 2 2 2 2 2 2 9
9 2 2 2 2 2 2 2 2 2 9 9 9 9
9 2 2 2 2 2 2 2 2 2 9 9 9 9
9 2 2 2 2 2 2 2 2 2 9 9 9 9
9 2 2 2 2 2 2 2 2 2 9 9 9 9
9 2 2 2 2 2 2 2 2 2 9 9 9 9
9 9 9 9 9 2 2 2 2 2 9 9 9 9
9 9 9 9 9 2 2 2 2 2 9 9 9 9
9 9 9 9 9 2 2 2 2 2 9 9 9 9
9 9 9 9 9 9 9 9 9 9 9 9 9 9